............
............
..p.........
............
....w#-#w...
....##d##...
....*.d./...
....##d##...
....w#2#w...
............
............
............
2
2
2
2
2
2
2
2
2
2
2
2