............
.....p......
............
...w.##.w...
...w.-#.w...
...w.##.w...
...w.#/.w...
...w.##.w...
...w.dd.w...
...wwwwww...
............
............
12
8
9
4
15
6
21
16