............
............
..wwwwwwww..
..wd.....w..
..w.###s.w..
..w.#p##.w..
..w.##-#.w..
..w./###.w..
..w.....dw..
..wwwwwwww..
............
............
20
10
7
5
4
9
13
15
12
100
2
3