............
.p..........
............
............
...#....#...
...#w**w#...
....*d.*....
....*.d*....
...#w**w#...
...#....#...
............
............
5
10
20
3
2
8
4
6