............
.p..-...*...
............
...w.w.w.w..
./..#.#.#...
...w.w.w.w..
....#.#.#.d.
...w.w.w.w..
.s..#.#.#...
...w.w.w.w..
......d...d.
............
1
4
12
20
10
9
8
16
34