............
.p..........
............
...#.ww.#...
....#..#....
...w.##.w...
...w.##.w...
....#..#....
...#.ww.#...
............
....d..d....
............
18
14
6
16
15
21
27
9
12
10
16
4