............
.....p......
............
............
..#.#..#.#..
...#.##.#...
............
...wwwwww...
..-/*d/d*2..
..wwwwwwww..
............
............
5
7
8
10
22
2
4
9