............
............
..#..p......
..#.........
..#..wwwwdww
..#..-......
..#..wwwwdww
..#..-......
..#..wwwwdww
..#..w......
.....w.d.#..
.....w......
10
9
1
6
25
20
4
15
1