.....ww.....
.....ww.....
.....ww.....
.....ww.....
..p..##..d..
.....##.....
.....##.....
..d..##..d..
.....ww.....
.....ww.....
.....ww.....
.....ww.....
4
10
3
9
10
6
25
10