............
.....p......
............
....w..w....
....w##w....
..www..www..
..#..##..#..
..www..www..
....w22w....
...d....d...
............
............
7
8
3
5
12
5