............
.p..........
..d###d##.d.
..#.d####.#.
..#.#.d##.#.
.d####d.#.#.
....d..###d.
..d##d#.#...
...#.#..#...
...#.d##d.#.
.d#d######d.
............
2
5
8
3
7
15
3
7
3
4
12
2
3
6
1
6
5
2
8
5
9
1
6
8
7
6
14
3
8
8
13
4
9
7
6
10
3
1
3
3
7
5
4
7