............
............
............
...p....d...
............
.....##.....
.....##.....
............
...d....d...
............
............
............
2
17
7
4
