............
............
............
...#.#.#.d..
............
...#.p.#.d..
............
...#.#.#.d..
............
.../.s.-....
............
............
49
11
36
8
7
3
9
13