.....ww.....
.....ww.....
..p..ww..#..
.....ww.....
..#..ww.....
.....d#.....
.....ww.....
..#..ww.....
.....ww..#..
..#..ww.....
.....ww.....
.....ww.d.d.
11
8
4
9
17
14