............
.p..........
............
...#.##.#...
.....-*.....
...#/dd2#...
...#*dd-#...
.....s/.....
...#.##.#...
............
............
............
9
10
21
12
4
30
8
6
20
42
25
16