............
.wwwwwwwwww.
.wd.#...#dw.
.w.##*s##.w.
.w#.#.#.##w.
.ws.#p.#.2w.
.w.##.-/#.w.
.w##.##..#w.
.w./#2..#.w.
.wd.#-#.-dw.
.wwwwwwwwww.
............
3
5
6
2
8
9
4
6
1
5
7
2
4
8
4
7
3
8
4
6
8
4
6
3
2