............
.p..........
............
...#######..
...#######..
...###d###..
...##ddd##..
...###d###..
...#######..
...#######..
............
............
8
9
4
3
1
0
4
8
4
9
3
8
6
5
3
2
0
4
1
4
8
0
4
5
7
8
9
7
4
0
1
2
3
4
6
9
7
1
5
4
2
8
5
1