............
............
..p.........
............
..*.w.d.w./.
...#..#..#..
..w.w#d#w.w.
....#.#.#...
..w.w#d#w.w.
...#..#..#..
..-.w.w.w.w.
............
8
20
14
11
7
2
13
5
17
3
10
12
30