............
............
............
.........d..
.....##.....
.p..####....
....####....
.....##.....
.........d..
............
............
............
10
4
3
20
9
6
8
15
12
7
2
30