............
............
.....p......
............
............
.w#w#ww#w#w.
.w.w.ww.w.w.
.w.w.ww.w.w.
..#.#..#.#..
ww#w#ww#w#ww
.wdwdwwdwdw.
..w..ww..w..
9
6
8
6
3
5
2
11
4
16
9
1