............
............
.....p......
............
...-#ww#/...
...#....#...
...wdwwdw...
...#....#...
.../#ww#-...
............
............
............
8
10
14
2
20
16
4
12